.......................|..............................|..........**................*|*.......................................................................
.......................|........****..................|.....|______................*|*.......................................................................
.............................|______........................|.........____...............................!...................................................
.............................|................______....................................____........_________................................................
..................______....................................................._______...........******........................................................