.......................|.......|........
............__............__............
.............|......|....|__............
................_..__....|..............
..............__..|p.....|..............