..............___.......................
.................|........._............
.................|.....|................
............._.........|................
...................p...|................