........................................
........................................
.........._.................*...........
..........*|_.........._...._....|......
...................p..|.................