....................|....._.............
................._.......|..............
.........._.......|.....................
...........|_.........._................
...................p..|.................