..............___.......................
.........................._..|..........
.........__................._|..........
............|_......_......__|..........
............|......p...._....|..........