.........................|............................................................|*..................|..............
.............................................*****...|...............................................!....|..............
...............................|______......._____...|........|......|.......__...|.........|___.......__.|..............
..........................|__........................|........|......|............|.....__..|............................
..................______..|..........................|........|......|............|.........|............................