...................___________..........
..................|...........|..|......
..................|....|___...|..|......
..................|__......|_____|......
..................|....____|............
..................|p...|................